1111111
1P00001
100C001
10EEE01
1111111
