11111111111111111111111111
10000000000000000000000001
10P00000000C000000000C0001
10001110000000001110000001
10000C00000000000C00000001
1C0000000011110000000C0001
10000000000C00000000000E01
11111111111111111111111111
