1111111
10P0001
100C001
10EEE01
1111111
