111111111111
10P000000001
10000CCC0001
1000000000E1
111111111111
