111111111111
10P000000C01
100000E00001
10C0S00000C1
111111111111
