1111111111111111111
1P000S000S0000000C1
10000000000000S0001
10000C00000C0000001
10S00000000000000S1
100000C00C00C0000E1
1111111111111111111
